=============================================================================================================================================================================================
=                                                                                                                                                                                           =
=                                                                                                                                                                                           =
=                                                                                                                                                                                           =
=                                                                                                                                                                                           =
=                                                                                                                                                                                           =
=                                                                                                                                                                                           =
=                                                                                                                                                                                           =
=                                                                                                                                                                                           =
=                                                                                                                                                                                           =
=                                                                                                                                                                                           =
=                                                                                                                                                                                           =
=                                                                                                                                                                                           =
=                                                                                                                                                                                           =
=                                                                                                                                                                                           =
=                                                                                                                                                                                           =
=                                                                                                                                                                                           =
=                                                                                                                                                                                           =
=                                                                                                                                                                                           =
=                                                                                                                                                                                           =
=                                                                                                                                                                                           =
=                                                                                                                                                                                           =
=                                                                                                                                                                                           =
=                                                                                                                                                                                           =
=                                                                                                                                                                                           =
=                                                                                                                                                                                           =
=                                                                                                                                                                                           =
=                                                                                                                                                                                           =
=                                                                                                                                                                                           =
=                                                                                                                                                                                           =
=                                                                                                                                                                                           =
=                                                                                                                                                                                           =
=                                                                                                                                                                                           =
=                                                                                                                                                                                           =
=                                                                                                                                                                                           =
=                                                                                                                                                                                           =
=                                                 =======                                                                                                                                   =
=                                                                                                                                                                                           =
=           ======                                                                                                                                                                          &
=                                                                                                                                                                                           &   
=                                               =                                                                                                                                           & 
=                        --                     =                                                                                                                               =============          
=                       =================       =                                                                                                                                           =          
=                                               =                                                                                                                    ===                    =          
=                                               =                                                                                                                                           =             
=                                               =                                                                                                                                           =          
= --                                            =                                        ===                                                                   ==                           =         
=====================                           =                                        ===                                                                   ==                           =            
=                                               =                       *   *            ===                  *             * *              *  *              ==                           =       
=                                               =                                        ===     ===                                                           ==                           =           
=                                               =                                        ===     ===                                                           ==                           =            
=                         --                --  =      --                                ===-----===               --                --               --       ==       ----------------    =
=============================================================================================================================================================================================