=============================================================================================================================================================================================
=                                                                                                                                                                                           =
=                                                                                                                                                                                           =
=                                                                                                                                                                                           =
=                                                                                                                                                                                           =
=                                                                                                                                                                                           =
=                                                                                                                                                                                           =
=                                                                                                                                                                                           =
=                                                                                                                                                                                           =
=                                                                                                                                                                                           =
=                                                                                                                                                                                           =
=                                                                                                                                                                                           =
=                                                                                                                                                                                           =
=                                                                                                                                                                                           =
=                                                                                                                                                                                           =
=                                                                                                                                                                                           =
=                                                                                                                                                                                           =
=                                                                                                                                                                                           =
=                                                                                                                                                                                           =
=                                                                                                                                                                                           =
=                                                                                                                                                                                           =
=                                                                                                                                                                                           =
=                                                                                                                                                                                           =
=                                                                                                                                                                                           =
=                                                                                                                                                                                           =
=                                                                                                                                                                                           =
=                                                                                                                                                                                           =
=                                                                                                                                                                                           =
=                                                                                                                                                                                           =
=                                                                                                                                                                                           =
=                                                                                                                                                                                           =
=                                                                                                                                                                                           =
=                                                                                                                                                                                           =
=                                                                                                                                                                                           =
=                                                                                                        *                                                 *                                =
=                                                 =======                     *                                                                                                             =
=                                                                                                                                                                                           =
=           ===                                                                                                =====                                                =====                   &
=                                                           =======                                                                                    =========                            &   
=                                               =                                                       ===                                 =====                                           & 
=                        --   -   --            =                          =======                                               --                                              =============          
=                       =================       =                                               -                           ========                                                          =          
=                   ==                          =                                          ======                                                                    ===                    =          
=                   ==                           =                                                                                                                                          =             
=                   ==                           =                                                                                                                                          =          
= --  --            ==                          =                                        ===                                                                   ==                           =         
===============     ==                          =                                        ===                                                                   ==                           =            
=                   ==                          =                       *   *            ===                  *             * *              *  *              ==                           =       
=                   ==              *            =                                        ===     ===                                                            ==                         =           
=                   ==                            =                                        ===     ===                                                           ==                         =            
=                   ==      --                --  =      --        --       --     --      ===-----===               --                --               --       ==       ----------------  =
=============================================================================================================================================================================================